#####################################
,,,,,,,,,,,,,,,,,,,,,...............#
,,,,,,,,,,,,,,,,,,,,,...............#
...................,,...............#
...................,,...............#
...................,,...............#
,,,,,,,,,,,,,,,,,,,,,,,,,,,,,,,,,,,,#
,,,,,,,,,,,,,,,,,,,,,,,,,,,,,,,,,,,,#
#####################################